37
28
22 22 22 22 22 22 22 4 0 0 0 0 0 0 0 0 0 0 0 0 0 0 0 0 0 0 0 3 22 22 22 22 19 17 17 18 22 
22 22 22 22 22 19 17 0 0 0 0 0 0 0 0 0 0 0 0 0 0 0 0 0 0 0 0 3 22 22 22 6 4 0 0 3 22 
22 22 22 22 22 4 0 0 0 0 0 0 0 0 0 0 0 0 0 0 0 0 0 0 0 0 0 3 22 22 22 5 9 0 0 3 22 
22 22 22 22 22 4 0 0 0 0 0 0 0 0 0 0 0 0 0 0 0 0 0 0 0 0 0 0 17 17 18 5 21 21 2 3 22 
22 22 22 22 19 0 0 0 0 0 0 0 23 24 24 24 25 0 0 0 0 0 0 0 0 0 0 0 0 0 0 0 17 17 0 3 22 
22 22 22 19 0 0 0 0 0 0 0 0 0 0 0 0 0 0 0 0 0 0 0 0 0 0 0 1 21 2 0 0 0 0 0 3 22 
22 22 22 4 1 21 21 21 2 0 0 0 0 0 0 0 0 0 0 0 0 0 0 0 23 24 25 3 22 4 0 0 0 0 10 3 22 
22 22 19 0 0 18 22 22 21 2 0 0 0 0 0 0 0 0 0 0 0 0 0 0 0 0 0 3 22 4 0 0 0 1 21 8 22 
22 19 0 0 0 0 18 22 22 21 2 0 11 0 0 0 0 0 0 0 0 0 0 0 0 0 0 3 22 4 0 0 0 0 17 3 22 
22 4 0 0 0 0 0 17 17 17 23 24 24 24 24 24 25 0 0 1 21 2 0 9 0 0 0 3 22 4 0 0 0 0 0 3 22 
22 4 0 0 0 0 0 0 0 0 0 0 0 0 0 0 0 0 0 0 17 0 1 21 2 0 0 3 22 4 1 21 21 2 0 3 22 
22 4 0 0 0 0 0 0 0 0 0 0 0 0 0 0 0 0 0 0 0 0 0 17 0 0 0 3 22 4 0 17 17 0 0 3 22 
22 4 0 0 0 0 0 0 0 0 0 0 0 0 0 0 0 0 0 0 0 0 0 0 0 0 1 21 22 4 0 0 0 0 0 3 22 
22 4 0 0 0 0 0 0 0 0 0 0 0 0 0 0 0 0 0 0 0 0 0 0 0 0 3 22 22 21 21 21 2 0 0 3 22 
22 4 0 0 0 0 0 0 0 0 0 0 0 0 0 0 0 0 1 21 21 21 21 21 21 21 21 21 22 19 17 17 0 0 0 3 22 
22 4 0 0 0 0 1 21 21 21 21 21 21 21 21 21 21 21 21 22 19 17 17 17 17 17 17 18 22 4 0 0 0 0 0 3 22 
22 4 0 1 21 21 21 22 22 22 22 4 0 0 0 0 0 0 3 22 4 0 0 0 0 0 0 23 22 4 0 0 0 0 0 3 22 
22 21 2 0 17 17 17 17 17 17 17 0 0 0 0 0 0 0 3 22 4 0 0 0 0 0 9 3 22 4 0 0 0 0 0 3 22 
22 22 4 1 21 2 0 0 0 0 0 0 0 0 0 0 0 1 21 22 4 0 0 0 1 21 21 21 22 4 0 0 0 0 0 3 22 
22 21 21 21 21 21 21 21 2 23 24 25 0 0 0 0 0 0 18 22 4 0 1 21 21 22 22 22 22 4 10 0 0 11 0 3 22 
22 19 17 17 17 17 17 17 0 0 0 0 0 0 0 0 0 23 25 22 4 0 0 17 17 17 17 18 22 8 21 21 21 21 21 21 6 
22 4 0 0 0 0 0 0 0 0 0 0 0 0 0 0 0 9 3 22 4 0 0 0 0 0 0 3 22 8 22 22 22 22 22 22 22 
22 4 0 9 0 0 0 0 0 0 0 0 0 0 0 23 24 24 25 22 4 0 0 0 0 0 0 3 22 4 0 0 0 0 0 18 22 
22 4 0 23 25 11 0 0 0 23 25 0 0 0 0 0 0 0 3 22 21 2 0 0 0 0 0 3 22 21 21 21 2 0 0 7 22 
22 4 0 0 0 23 24 24 25 0 0 0 0 0 0 0 0 0 0 17 17 0 0 0 0 0 0 3 22 22 22 22 21 2 9 20 22 
22 21 2 0 0 0 0 0 0 0 0 0 0 0 0 0 0 0 0 0 0 0 0 0 0 0 0 3 22 22 22 22 22 21 21 21 22 
22 22 21 21 2 0 0 0 1 21 21 21 21 21 21 21 21 21 21 21 21 21 21 21 21 21 21 21 22 22 22 22 22 22 22 22 22 
22 22 22 22 21 21 21 21 21 22 22 22 22 22 22 22 22 22 22 22 22 22 22 22 22 22 22 22 22 22 22 22 22 22 22 22 22 
